# # # # # # #
# 2 4 5 6 # #
# 1 # # # # #
# 0 # # # # #
# # # # # # #
