8 20 80
####################
#  *****          ##
######### #######I@#
## >       ***  # ##
######### ##########
####################
#       ******    @#
####################
