# # # # # # # # # #
# # # 32 31 30 29 # # #
# # # # # # 28 27 26 #
# # # # # 1 # # 25 #
# # # # # 2 # # 24 #
# # # # # 3 # 22 23 #
# # # # # 4 # # 17 #
# # # # # 5 # # 16 #
# # 9 10 11 12 13 14 15 #
# # # # # # # # # #
