6 9 30
#########
#* * B# #
#  *    #
#  ###* #
#>    P #
#########
