# # # # # # # # # # # # # # # # # # # #
# 6 7 8 9 10 11 12 13 14 15 # # # # # # # # #
# 5 # # # # # # # # 16 21 22 23 24 25 26 30 39 #
# 4 3 2 1 0 # # # 18 19 20 # # # # # # # #
# # # # # # # # # # # # # # # # # # # #
# # # # # # # # # # # # # # # # # # # #
# 39 40 41 42 43 44 45 46 47 48 # # # # # # # # #
# # # # # # # # # # # # # # # # # # # #
