# # # # # # # # # #
# # 10 # # # # # # #
# # 11 # # # # # # #
# 13 12 # # 48 47 46 45 #
# 14 # # # 49 # # 44 #
# 15 2 1 0 50 55 54 43 #
# 20 19 # # 51 52 53 42 #
# 21 # # 34 38 # # # #
# 22 23 24 35 37 31 30 # #
# # # # # # # # # #
