# # # # # # #
# 3 4 5 6 8 #
# 2 # 13 12 11 #
# 1 # # # 10 #
# 0 # # # # #
# # # # # # #
