11 30 90
##############################
#         ********          ##
# #########################*##
# #########################*##
#>###***************    ###*##
# ### #################@###*##
##### #####################*##
#@###************          *##
# ############################
#*############################
##############################
