8 20 80
####################
#  *****   #########
# ########        @#
#    > ##*  ########
####################
##P#################
#@    *****#########
####################
