# # # # # # # # #
# # # # # # # # #
# # # # # # # 16 #
# # # # # # 13 14 #
# # # # # # # 11 #
# # # # # # # 10 #
# # # # 4 5 # 9 #
# 0 1 2 3 6 7 8 #
# # # # # # # # #
