# # # # # # # # #
# 3 # # # # # # #
# 4 5 6 7 11 12 # #
# 1 # # # # # # #
# 0 # # # # # # #
# # # # # # # # #
