10 10 32
##########
#        #
# ###    #
#*###>## #
# ### ## #
#I### C**#
# ### ## #
# ### ## #
# *  *   #
##########
